___T__T__
__TT__TT_
_________
TTTT__T__
_________
_________
____X____